MOR - M-zine

Timberline - FD

Seawolf - Cause4Concern

Medicine (Matrix Remix) - Ed Rush & Optical

Twisted City (Ft.Keaton) 2021 Remaster - Dom & Roland

Problem Kid (Sonar Remix) - 

Run Away - Molecular & Dunk

Creatures - Gonzo Transmission (Instrumental) -Patreon Exclusive March- - 

Hyroglifics - Dog Town v3 - Hyroglifics

3 - Klippee - Reset (Master Vinyl Updated) - 

Halogen - Housty

Keep The Beat Going - Black Barrel

Chum - Circumference

Stone Cold - Nymfo

Eidolon - Ephyum & Invadhertz

TESTAMENT - MIRRORMAN AND SUBMOTIVE

Schachror - Mako & Villem

Trick - Hydro, DLR

DLR, Focuz Perception - Rift

Stasis (Waeys Remix) - Black Sun Empire

Mode M (VIP) - Gridlok, Prolix

Bullit - Ed Rush & Optical

The Computer - Molecular

Run Away - Molecular & Dunk

Airhead - Matrix

Out Of Control (Cause 4 Concern Remix) - Spirit

Re-Animation - Kemal

SUSTANCE - AMNESIA - PATEXDUB001 - Sustance

Combine & Klippee - Bootloader - VSN 37 send back to ken - 

Memories of You - Wingz

Rockin - Black Barrel

Escapism - Ephyum & Invadhertz

The Hunt - Minor Forms

Waeys - Mapper (Tacktile Remix) Comp Winner - 

Waeys - Mapper (Infrah Remix) [onezero master] - 

Amoss - Signals (Wired Master) - 

Dreamworld - Marcus Intalex & S.T. Files

Mixed Bag feat. DRS - Marcus Intalex

Incoming - Ram Trilogy

Compound (Gridlok Remix) - Ed Rush and Optical

Death Threat Dub - Keaton & Hive

Ghobi Ghost - The Upbeats

Barracuda - M.I.S.T.

Kridian - Trace & Optical

Killa Bees  - Usual Suspects

Standing Room Only - Hive & Gridlok

The Plague  - Hive, Keaton

Bullet Time (Spor Remix) - Bad Company UK

Out Of Perspective - SCAR

Spaceage - TeeBee

Droids - Teebee

Scatter - Andy Skopes & Madcap

The Mercenary - Mako & Andy Skopes

Combat - Black Barrel

Redux - M-zine

PUSH - MIRRORMAN

Headhunter - Nymfo

BK-IMPULSE - 

Klippee & Combine - Underscore v12 - 

Demo, RFTV Murder Hornet v15 - Demo. RFTV

A Storm on a Summers Day - Hyroglifics

Hookworm - Akkrid & Distrikt

Steam Train  - Break

Bunny Hop - Nymfo

Set The Swing  - Monty

Here With Me - FD

Matter - Data 3

Wave Function - Data 3

