Heady One - Cloud Lord

MOR - M-zine

Kid Drama & Ryme Tyme - Switch - Kid Drama & Ryme Tyme

The Hunt - Minor Forms

The Ends - The Sauce

Rockin - Black Barrel

TESTAMENT - MIRRORMAN AND SUBMOTIVE

Compound (Gridlok Remix) - Ed Rush & Optical

Drum Kru - Rigmasher - 

Ed Rush & Optical and Fierce - Pod - 

Authentic - Break

Watermelon - Ed Rush &  Optical

French Kiss (Ed Rush & Optical Remix) - Lil' Louis

Funkstation - Ram Trilogy

Beastman - Ram Trilogy

Mordor - Dom & Keaton

Therapy - Usual Suspects

Vapourspace - Cause4Concern

Radiator Funk - Arkaik

Eidolon - Ephyum & Invadhertz

Timberline - FD

Stone Cold - Nymfo

Stress Test - Trex

Blej - Halogenix

Minimal Instinkt - Kiril

That Bloody Pookie - missledz

Chase The Ace - missledz

Won't You - missledz

The Bromeliad Society - missledz

Charade (Vocal Mix)_Ozone - Grooverider

Untitled Ghost - Artificial Intelligence

Mind Killer - Cause4Concern

Cryptic - SHADES (UK)

Creepin' - Shades

Swish - Hyroglifics

Steam Roller - Root for the Villain

Murder Sound VIP - Root for the Villain

BnB.I.P - Root for the Villain

SKURRT v7 - Dave Owen, RFTV

Make you Sweat v13 - RFTV

Do It Like This - Klippee

Ghee - Ivy Lab

Foxholes - Emperor

Creatures - Don't you_ (Patreon Exclusive)  - 

100 Next Level Robot - The Sauce

Halogen - Housty

Frame of Mind feat. Prophecy Mc  - Housty, Prophecy Mc

Unfulfilled - Wingz

Facts On - Kendot

So Below - Need For Mirrors

Problems - The Sauce

Ramparts - Serum

Folder - Survival, Script

Milky Way - Ram Trilogy

Piston - Gridlok And Kaos

Ladies of Spain - Bad Company UK

Submarines (Original 2001 Mix) - Fresh

Jellybean (Instrumental) - Bad Company UK

