The Shining (Ed Rush & Optical Remix) - Optical

You Got Nothing - Survival

12 Bits (Mako's Breakout Rmx) - Paradox, Nucleus

Brutal D - Kid Drama

In the Lurch feat. LJC - Digital

Breaks and Pads - Mikal

Tear out My Heart feat. Jenna G (2020 Remaster) - Future Cut

Move Upon - Jonny L

Angel (Teebee Remix) - Rufige Kru

Hide The Tears (Remix) - Kryptic Minds & Leon Switch

Dreada - Mister Shifter

Behind Me - Wingz

Shifted - Visages, Trail

Need U - Koherent & Monrroe

Illumination (Black_Barrel_Remix) - Black Barrel

Impulse 1 (Commix Remix) - Kid Drama

Unfulfilled - Wingz

Here With Me - FD

Sunk - Screamarts

Creeper feat. Chimpo - Upgrade, Chimpo, Bou

Vortex - Particle & T>I

Temple - Creatures

Never Last - Rift

Antidote - Annix

Mercy & Misery - Hyroglifics & AC13

Vega - Emperor

Up All Night (Data 3 Remix) - John B

Matter - Data 3

Wave Function - Data 3

Schachror - Mako & Villem

Trick - Hydro, DLR

Dozer - Ed Rush, Optical

Fibre-Optic - Optical

My Tearz feat. Steo (Ulterior Motive Remix) - Lenzman

Just Warmin Up - Dillinja

Thugs - Dillinja

DLR, Focuz Perception - Rift

The Process feat. DRS - Enei, Drs

Test Tube - Kemal & Rob Data

Gene Sequence - Kemal + Rob Data

Memories of You - Wingz

A Storm on a Summers Day - Hyroglifics

Barracuda - Marcux Intalex & St Files

Boxing - Eastcolors

Mistical Dub, Pt. 2 - Nu:Tone

Robots (Ulterior Motive Remix) - Zero T, Bailey

About You - Visages, Laville

Architect - Kid Drama

Vertigo - Matrix, Danny J

Drift Away - The Invaderz

Glare - Fixate

Don't Talk (Foreign Concept Remix) - Stranjah, Foreign Concept, Tony Ranks

Peking Man - Radiax

White Goat - Koax

Bully - FD

Affection feat. Sammie Hall - Wingz

Droog - Scepticz

Olivia Rose - Heaven (En:vy Remix) - Olivia Rose, En:vy

Fokus - Black Barrel

Speed Era - Arkaik

What You Had feat. Steo (Lenzman Remix) - Artificial Intelligence

Revive - Logistics, Eva Lazarus, Etherwood

Check-Out Time - Ed Rush, Optical

See Through - Fierce, Zero T

When The Lights Go Down - High Contrast

Tombraider - Fresh

Is It U (Ozone) - Calibre

Tribes VIP - Monty

Upload - Hyroglifics, Sustance

Fallen - Ill Truth

Valhalla - Breakage, James Boyle

I Adore You (Total Science Remix) - Goldie & Ulterior Motive Featuring Natalie Williams